1 3 11 3 11 10
WWWWWWWWWWWWW
WFFFFFFFFFFFW
WFWBBBWBBBWFW
WFBWFFWFFWBFW
WFBFWFWFWFBFW
WFBFFFBFFFBFW
WFWWWBBBWWWFW
WFBFFFBFFFBFW
WFBFWFWFWFBFW
WFBWFFWFFWBFW
WFWBBBWBBBWFW
WFFFFFFFFFFFW
WWWWWWWWWWWWW