1 3 11 3 11 10
WWWWWWWWWWWWW
WFFFFFFFFFFFW
WFWWWWFWWWWFW
WFWBFBFBFBWFW
WFWFWFWFWFWFW
WFWBFBFBFBWFW
WFFFWFWFWFFFW
WFWBFBFBFBWFW
WFWFWFWFWFWFW
WFWBFBFBFBWFW
WFWWWWFWWWWFW
WFFFFFFFFFFFW
WWWWWWWWWWWWW