1 3 11 3 11 10
WWWWWWWWWWWWW
WBFFBFFFFBFFW
WFWFWFWFWFWFW
WFFFFFBFBFFFW
WFWFWBWBWFWBW
WFFFFFBFFFFFW
WFWFWFWFWFWFW
WBFBBFFFBBFFW
WFWFWBWFWFWFW
WBFFBFFFFFFFW
WFWFWFWFWFWFW
WFFBFFBFBFFFW
WWWWWWWWWWWWW
