WWWWWWWWWWWWW
WBFFBFFFFBFFW
WFWFWFWFWFWFW
WFFFFFBFBFFFW
WBFFBFFFFBFFW
WFWFWFWFWFWFW
WFFFFFBFBFFFW
WBFFBFFFFBFFW
WFWFWFWFWFWFW
WFFFFFBFBFFFW
WBFFBFFFFBFFW
WFWFWFWFWFWFW
WWWWWWWWWWWWW
