1 3 11 3 11 10
WWWWWWWWWWWWW
WFFFFFFFFFFFW
WFWWWWFWWWWFW
WFWBFFFFFBWFW
WFWFWFWFWFWFW
WFWFFBFBFFWFW
WFFFWFWFWFFFW
WFWFFBFBFFWFW
WFWFWFWFWFWFW
WFWBFFFFFBWFW
WFWWWWFWWWWFW
WFFFFFFFFFFFW
WWWWWWWWWWWWW