1 3 1 5
WWWWWWWWWWWWW
WFFFFFFFFFFFW
WBBBBBBBBBBBW
WFFFFFFFFFFFW
WBBBBBBBBBBBW
WFFFFFFFFFFFW
WBBBBBBBBBBBW
WFFFFFFFFFFFW
WBBBBBBBBBBBW
WFFFFFFFFFFFW
WBBBBBBBBBBBW
WFFFFFFFFFFFW
WWWWWWWWWWWWW
