1 1 3 1
WWWWW
WFFFW
WBFFW
WWWWW
